1111111111111111111111111111
1E0010C000000000000000000001
1000111000000000000000000001
1P000000000000000000000000011
1000000000000000000000000001
100C000000000000000000000001
1111111111111111111111111111