1111111111111
1C00000000C01
1100011111001
1P0011E000001
1111111111111
