1111111111111111111111111111111111111111111111111111111111111111
1000000000000000001000000001110000000000000000000000000000000001
1000000000000000001000000001110000000000000000000000000000000001
1000000C00000000001111111111110000000000000000000000000000000001
1000000000000000000000000000000000000000000000000000000000000001
10000000000000000000000000000000000000000000000000000000P0000E01
1000000000000000000000000000000000000000000000000000000000000001
1000000000000000000000000000000000000000000000000000000000000001
1000000000000000001111111111110000000000000000000000000000000001
1000000000000000001000000000010000000000000000000000000000000001
1000000000000000001000000000010000000000000000000000000000000001
1000000000000000001000000000010000000000000000000000000000000001
1111111111111111111000000000010000000000000000000000000000000001
1000000000000000000000000000010000000000000000000000000000000001
1000000000000000000000000000010000000000000000000000000000000001
1000000000000000000000000000010000000000000000000000000000000001
1000000000000000000000000000010000000000000000000000000000000001
1000000000000000000000000000010000000000000000000000000000000001
1000000000000000000000000000010000000000000000000000000000000001
1000000000000000000000000000010000000000000000000000000000000001
1000000000000000000000000000010000000000000000000000000000000001
1111111111111111111111111111110000000000000001111111111111111111
1000000000000000000000000000000000000000000001111111111111111111
1000000000000000000000000000000000000000000001000000000000000001
1000000000000000000000000000000000000000000001000000000000000001
1000000000000000000000000000000000000000000001000000000000000001
1000000000000000000000000000000000000000000001000000000000000001
1000000000000000000000000000000000000000000001000000000000000001
1000000000000000000000000000000000000000000001000000000000000001
1000000000000000000000000000000000000000000001000000000000000001
1000000000000000000000000000000000000000000001000000000000000001
1000000000000000000000000000000000000000000001000000000000000001
1000000000000000000000000000000000000000000001000000000000000001
1000000000000000000000000000000000000000000001000000000000000001
1000000000000000000000000000000000000000000001000000000000000001
1111111111111111111111111111111111111111111111111111111111111111
